*************
*****B     **
*   ****** **
* ******** **
*           *
*** **** ****
*** **** ****
**          *
*********** *
**A         *
*************