#################
#B              #
############### #
#         #     #
###### ######## #
#               #
####### #########
#######        A#
#################